


        R 1200 700



NO  ./pics/colorstone.xpm
SO  ./pics/bluestone.xpm

S   ./pics/pillar.xpm

EA  ./pics/purplestone.xpm

WE  ./pics/eagle.xpm


F 255, 255, 255


         C 225,30,0

11111111111111
11000000000000111
10000000000001111111111
110020000000000000000001
100000000000111111100111
10000002000002002011001
1110020E00201111111111
  1111111111111111

